On the Convergence of Adam and Beyond	Sashank J. Reddi, Satyen Kale, Sanjiv Kumar
Synthetic and Natural Noise Both Break Neural Machine Translation	Yonatan Belinkov, Yonatan Bisk
Multi-Scale Dense Networks for Resource Efficient Image Classification	Gao Huang, Danlu Chen, Tianhong Li, Felix Wu, Laurens van der Maaten, Kilian Weinberger
Training and Inference with Integers in Deep Neural Networks	Shuang Wu, Guoqi Li, Feng Chen, Luping Shi
Emergence of Linguistic Communication from Referential Games with Symbolic and Pixel Input	Angeliki Lazaridou, Karl Moritz Hermann, Karl Tuyls, Stephen Clark
Spherical CNNs	Taco S. Cohen, Mario Geiger, Jonas KÃ¶hler, Max Welling
Ask the Right Questions: Active Question Reformulation with Reinforcement Learning	Christian Buck, Jannis Bulian, Massimiliano Ciaramita, Wojciech Gajewski, Andrea Gesmundo, Neil Houlsby, Wei Wang.
On the insufficiency of existing momentum schemes for Stochastic Optimization	Rahul Kidambi, Praneeth Netrapalli, Prateek Jain, Sham M. Kakade
Certifying Some Distributional Robustness with Principled Adversarial Training	Aman Sinha, Hongseok Namkoong, John Duchi
Learning Deep Mean Field Games for Modeling Large Population Behavior	Jiachen Yang, Xiaojing Ye, Rakshit Trivedi, Huan Xu, Hongyuan Zha
Wasserstein Auto-Encoders	Ilya Tolstikhin, Olivier Bousquet, Sylvain Gelly, Bernhard Schoelkopf
Spectral Normalization for Generative Adversarial Networks	Takeru Miyato, Toshiki Kataoka, Masanori Koyama, Yuichi Yoshida
Learning to Represent Programs with Graphs	Miltiadis Allamanis, Marc Brockschmidt, Mahmoud Khademi
Characterizing Adversarial Subspaces Using Local Intrinsic Dimensionality	Xingjun Ma, Bo Li, Yisen Wang, Sarah M. Erfani, Sudanthi Wijewickrema, Grant Schoenebeck, Dawn Song, Michael E. Houle, James Bailey
Breaking the Softmax Bottleneck: A High-Rank RNN Language Model	Zhilin Yang, Zihang Dai, Ruslan Salakhutdinov, William W. Cohen
Continuous Adaptation via Meta-Learning in Nonstationary and Competitive Environments	Maruan Al-Shedivat, Trapit Bansal, Yura Burda, Ilya Sutskever, Igor Mordatch, Pieter Abbeel
Boosting Dilated Convolutional Networks with Mixed Tensor Decompositions	Nadav Cohen, Ronen Tamari, Amnon Shashua
Neural Sketch Learning for Conditional Program Generation	Vijayaraghavan Murali, Letao Qi, Swarat Chaudhuri, Chris Jermaine
Progressive Growing of GANs for Improved Quality, Stability, and Variation	Tero Karras, Timo Aila, Samuli Laine, Jaakko Lehtinen
Variance Reduction for Policy Gradient with Action-Dependent Factorized Baselines	Cathy Wu, Aravind Rajeswaran, Yan Duan, Vikash Kumar, Alexandre M Bayen, Sham Kakade, Igor Mordatch, Pieter Abbeel
Zero-Shot Visual Imitation	Deepak Pathak, Parsa Mahmoudieh, Guanghao Luo, Pulkit Agrawal, Dian Chen, Yide Shentu, Evan Shelhamer, Jitendra Malik, Alexei A. Efros, Trevor Darrell
Beyond Word Importance: Contextual Decomposition to Extract Interactions from LSTMs	W. James Murdoch, Peter J. Liu, Bin Yu
AmbientGAN: Generative models from lossy measurements	Ashish Bora, Eric Price, Alexandros G. Dimakis
Minimal-Entropy Correlation Alignment for Unsupervised Deep Domain Adaptation	Pietro Morerio, Jacopo Cavazza, Vittorio Murino
Large Scale Optimal Transport and Mapping Estimation	Vivien Seguy, Bharath Bhushan Damodaran, Remi Flamary, Nicolas Courty, Antoine Rolet, Mathieu Blondel
TRUNCATED HORIZON POLICY SEARCH: COMBINING REINFORCEMENT LEARNING & IMITATION LEARNING	Wen Sun, J. Andrew Bagnell, Byron Boots
Model-Ensemble Trust-Region Policy Optimization	Thanard Kurutach, Ignasi Clavera, Yan Duan, Aviv Tamar, Pieter Abbeel
A Neural Representation of Sketch Drawings	David Ha, Douglas Eck
Deep Learning with Logged Bandit Feedback	Thorsten Joachims, Adith Swaminathan, Maarten de Rijke
Learning Latent Permutations with Gumbel-Sinkhorn Networks	Gonzalo Mena, David Belanger, Scott Linderman, Jasper Snoek
Learning an Embedding Space for Transferable Robot Skills	Karol Hausman, Jost Tobias Springenberg, Ziyu Wang, Nicolas Heess, Martin Riedmiller
Unsupervised Learning of Goal Spaces for Intrinsically Motivated Goal Exploration	Alexandre Pere, Sebastien Forestier, Olivier Sigaud, Pierre-Yves Oudeyer
Multi-View Data Generation Without View Supervision	Mickael Chen, Ludovic Denoyer, Thierry Artieres
Deep Bayesian Bandits Showdown: An Empirical Comparison of Bayesian Deep Networks for Thompson Sampling	Carlos Riquelme, George Tucker, Jasper Snoek
Semantic Interpolation in Implicit Models	Yannic Kilcher, Aurelien Lucchi, Thomas Hofmann
Fidelity-Weighted Learning	Mostafa Dehghani, Arash Mehrjou, Stephan Gouws, Jaap Kamps, Bernhard Scholkopf
Latent Space Oddity: on the Curvature of Deep Generative Models	Georgios Arvanitidis, Lars Kai Hansen, S??ren Hauberg
Imitation Learning from Visual Data with Multiple Intentions	Aviv Tamar, Khashayar Rohanimanesh, Yinlam Chow, Chris Vigorito, Ben Goodrich, Michael Kahane, Derik Pridmore
Hyperparameter optimization: a spectral approach	Elad Hazan, Adam Klivans, Yang Yuan
Leveraging Grammar and Reinforcement Learning for Neural Program Synthesis	Rudy Bunel, Matthew Hausknecht, Jacob Devlin, Rishabh Singh, Pushmeet Kohli
Efficient Sparse-Winograd Convolutional Neural Networks	Xingyu Liu, Jeff Pool, Song Han, William J. Dally
Espresso: Efficient Forward Propagation for Binary Deep Neural Networks	Fabrizio Pedersoli, George Tzanetakis, Andrea Tagliasacchi
Auto-Conditioned Recurrent Networks for Extended Complex Human Motion Synthesis	Yi Zhou, Zimo Li, Shuangjiu Xiao, Chong He, Zeng Huang, Hao Li
Decoupling the Layers in Residual Networks	Ricky Fok, Aijun An, Zana Rashidi, Xiaogang Wang
Polar Transformer Networks	Carlos Esteves, Christine Allen-Blanchette, Xiaowei Zhou, Kostas Daniilidis
Enhancing The Reliability of Out-of-distribution Image Detection in Neural Networks	Shiyu Liang, Yixuan Li, R. Srikant
Stabilizing Adversarial Nets with Prediction Methods	Abhay Yadav, Sohil Shah, Zheng Xu, David Jacobs, Tom Goldstein
Graph Attention Networks	Petar Veli?kovi?, Guillem Cucurull, Arantxa Casanova, Adriana Romero, Pietro Lio, Yoshua Bengio
Minimax Curriculum Learning: Machine Teaching with Desirable Difficulties and Scheduled Diversity	Tianyi Zhou, Jeff Bilmes
Generalizing Hamiltonian Monte Carlo with Neural Networks	Daniel Levy, Matt D. Hoffman, Jascha Sohl-Dickstein
An Online Learning Approach to Generative Adversarial Networks	Paulina Grnarova, Kfir Y Levy, Aurelien Lucchi, Thomas Hofmann, Andreas Krause
Improving GANs Using Optimal Transport	Tim Salimans, Han Zhang, Alec Radford, Dimitris Metaxas
The Kanerva Machine: A Generative Distributed Memory	Yan Wu, Greg Wayne, Alex Graves, Timothy Lillicrap
Mixed Precision Training	Paulius Micikevicius, Sharan Narang, Jonah Alben, Gregory Diamos, Erich Elsen, David Garcia, Boris Ginsburg, Michael Houston, Oleksii Kuchaiev, Ganesh Venkatesh, Hao Wu
Latent Constraints: Learning to Generate Conditionally from Unconditional Generative Models	Jesse Engel, Matthew Hoffman, Adam Roberts
MaskGAN: Better Text Generation via Filling in the _______	William Fedus, Ian Goodfellow, Andrew M. Dai
Divide and Conquer Networks	Alex Nowak, David Folque, Joan Bruna
Meta-Learning and Universality: Deep Representations and Gradient Descent can Approximate any Learning Algorithm	Chelsea Finn, Sergey Levine
Maximum a Posteriori Policy Optimisation	Abbas Abdolmaleki, Jost Tobias Springenberg, Yuval Tassa, Remi Munos, Nicolas Heess, Martin Riedmiller
META LEARNING SHARED HIERARCHIES	Kevin Frans, Jonathan Ho, Xi Chen, Pieter Abbeel, John Schulman
Deep Neural Networks as Gaussian Processes	Jaehoon Lee, Yasaman Bahri, Roman Novak, Samuel S. Schoenholz, Jeffrey Pennington, Jascha Sohl-Dickstein
Syntax-Directed Variational Autoencoder for Structured Data	Hanjun Dai, Yingtao Tian, Bo Dai, Steven Skiena, Le Song
Neural-Guided Deductive Search for Real-Time Program Synthesis from Examples	Ashwin Kalyan, Abhishek Mohta, Oleksandr Polozov, Dhruv Batra, Prateek Jain, Sumit Gulwani
Evidence Aggregation for Answer Re-Ranking in Open-Domain Question Answering	Shuohang Wang, Mo Yu, Jing Jiang, Wei Zhang, Xiaoxiao Guo, Shiyu Chang, Zhiguo Wang, Tim Klinger, Gerald Tesauro, Murray Campbell
WRPN: Wide Reduced-Precision Networks	Asit Mishra, Eriko Nurvitadhi, Jeffrey J Cook, Debbie Marr
MGAN: Training Generative Adversarial Nets with Multiple Generators	Quan Hoang, Tu Dinh Nguyen, Trung Le, Dinh Phung
The Reactor: A fast and sample-efficient Actor-Critic agent for Reinforcement Learning	Audrunas Gruslys, Will Dabney, Mohammad Gheshlaghi Azar, Bilal Piot, Marc Bellemare, Remi Munos
SEARNN: Training RNNs with global-local losses	Remi Leblond, Jean-Baptiste Alayrac, Anton Osokin, Simon Lacoste-Julien
Distributed Distributional Deterministic Policy Gradients	Gabriel Barth-Maron, Matthew W. Hoffman, David Budden, Will Dabney, Dan Horgan, Dhruva TB, Alistair Muldal, Nicolas Heess, Timothy Lillicrap
Hierarchical Subtask Discovery with Non-Negative Matrix Factorization	Adam C. Earle, Andrew M. Saxe, Benjamin Rosman
Parametrized Hierarchical Procedures for Neural Programming	Roy Fox, Richard Shin, Sanjay Krishnan, Ken Goldberg, Dawn Song, Ion Stoica
Viterbi-based Pruning for Sparse Matrix with Fixed and High Index Compression Ratio	Dongsoo Lee, Daehyun Ahn, Taesu Kim, Pierce I. Chuang, Jae-Joon Kim
cGANs with Projection Discriminator	Takeru Miyato, Masanori Koyama
Unsupervised Representation Learning by Predicting Image Rotations	Spyros Gidaris, Praveer Singh, Nikos Komodakis
Emergent Communication in a Multi-Modal, Multi-Step Referential Game	Katrina Evtimova, Andrew Drozdov, Douwe Kiela, Kyunghyun Cho
FastGCN: Fast Learning with Graph Convolutional Networks via Importance Sampling	Jie Chen, Tengfei Ma, Cao Xiao
Emergent Translation in Multi-Agent Communication	Jason Lee, Kyunghyun Cho, Jason Weston, Douwe Kiela
An efficient framework for learning sentence representations	Lajanugen Logeswaran, Honglak Lee
NerveNet: Learning Structured Policy with Graph Neural Networks	Tingwu Wang, Renjie Liao, Jimmy Ba, Sanja Fidler
Learning Latent Representations in Neural Networks for Clustering through Pseudo Supervision and Graph-based Activity Regularization	Ozsel Kilinc, Ismail Uysal
Adversarial Dropout Regularization	Kuniaki Saito, Yoshitaka Ushiku, Tatsuya Harada, Kate Saenko
Demystifying MMD GANs	Miko??aj Bi?kowski, Dougal J. Sutherland, Michael Arbel, Arthur Gretton
Smooth Loss Functions for Deep Top-k Classification	Leonard Berrada, Andrew Zisserman, M. Pawan Kumar
Deep Learning as a Mixed Convex-Combinatorial Optimization Problem	Abram L. Friesen, Pedro Domingos
Learning Approximate Inference Networks for Structured Prediction	Lifu Tu, Kevin Gimpel
LEARNING TO SHARE: SIMULTANEOUS PARAMETER TYING AND SPARSIFICATION IN DEEP LEARNING	Dejiao Zhang, Haozhu Wang, Mario Figueiredo, Laura Balzano
Model compression via distillation and quantization	Antonio Polino, Razvan Pascanu, Dan Alistarh
Variational Message Passing with Structured Inference Networks	Wu Lin, Nicolas Hubacher, Mohammad Emtiyaz Khan
Action-dependent Control Variates for Policy Optimization via Stein Identity	Hao Liu*, Yihao Feng*, Yi Mao, Dengyong Zhou, Jian Peng, Qiang Liu
Variational image compression with a scale hyperprior	Johannes Balle, David Minnen, Saurabh Singh, Sung Jin Hwang, Nick Johnston
Variational Inference of Disentangled Latent Concepts from Unlabeled Observations	Abhishek Kumar, Prasanna Sattigeri, Avinash Balakrishnan
Flipout: Efficient Pseudo-Independent Weight Perturbations on Mini-Batches	Yeming Wen, Paul Vicol, Jimmy Ba, Dustin Tran, Roger Grosse
Kernel Implicit Variational Inference	Jiaxin Shi, Shengyang Sun, Jun Zhu
A Scalable Laplace Approximation for Neural Networks	Hippolyt Ritter, Aleksandar Botev, David Barber
The High-Dimensional Geometry of Binary Neural Networks	Alexander G. Anderson, Cory P. Berg
Apprentice: Using Knowledge Distillation Techniques To Improve Low-Precision Network Accuracy	Asit Mishra, Debbie Marr
Distributed Prioritized Experience Replay	Dan Horgan, John Quan, David Budden, Gabriel Barth-Maron, Matteo Hessel, Hado van Hasselt, David Silver
Learning from Between-class Examples for Deep Sound Recognition	Yuji Tokozume, Yoshitaka Ushiku, Tatsuya Harada
Training Confidence-calibrated Classifiers for Detecting Out-of-Distribution Samples	Kimin Lee, Honglak Lee, Kibok Lee, Jinwoo Shin
VoiceLoop: Voice Fitting and Synthesis via a Phonological Loop	Yaniv Taigman, Lior Wolf, Adam Polyak, Eliya Nachmani
Large scale distributed neural network training through online distillation	Rohan Anil, Gabriel Pereyra, Alexandre Passos, Robert Ormandi, George E. Dahl, Geoffrey E. Hinton
Learning Differentially Private Recurrent Language Models	H. Brendan McMahan, Daniel Ramage, Kunal Talwar, Li Zhang
Mastering the Dungeon: Grounded Language Learning by Mechanical Turker Descent	Zhilin Yang, Saizheng Zhang, Jack Urbanek, Will Feng, Alexander Miller, Arthur Szlam, Douwe Kiela, Jason Weston
Generating Wikipedia by Summarizing Long Sequences	Peter J. Liu*, Mohammad Saleh*, Etienne Pot, Ben Goodrich, Ryan Sepassi, Lukasz Kaiser, Noam Shazeer
Unsupervised Machine Translation Using Monolingual Corpora Only	Guillaume Lample, Alexis Conneau, Ludovic Denoyer, Marc'Aurelio Ranzato
A Deep Reinforced Model for Abstractive Summarization	Romain Paulus, Caiming Xiong, Richard Socher
Compressing Word Embeddings via Deep Compositional Code Learning	Raphael Shu, Hideki Nakayama
Deep Gradient Compression: Reducing the Communication Bandwidth for Distributed Training	Yujun Lin, Song Han, Huizi Mao, Yu Wang, Bill Dally
QANet: Combining Local Convolution with Global Self-Attention for Reading Comprehension	Adams Wei Yu, David Dohan, Minh-Thang Luong, Rui Zhao, Kai Chen, Mohammad Norouzi, Quoc V. Le
Unsupervised Neural Machine Translation	Mikel Artetxe, Gorka Labaka, Eneko Agirre, Kyunghyun Cho
Learning One-hidden-layer Neural Networks with Landscape Design	Rong Ge, Jason D. Lee, Tengyu Ma
Critical Points of Linear Neural Networks: Analytical Forms and Landscape Properties	Yi Zhou, Yingbin Liang
Learning Parametric Closed-Loop Policies for Markov Potential Games	Sergio Valcarcel Macua, Javier Zazo, Santiago Zazo
The power of deeper networks for expressing natural functions	David Rolnick, Max Tegmark
Empirical Risk Landscape Analysis for Understanding Deep Neural Networks	Pan Zhou, Jiashi Feng
On the Discrimination-Generalization Tradeoff in GANs	Pengchuan Zhang, Qiang Liu, Dengyong Zhou, Tao Xu, Xiaodong He
Decision-Based Adversarial Attacks: Reliable Attacks Against Black-Box Machine Learning Models	Wieland Brendel *, Jonas Rauber *, Matthias Bethge
Unbiased Online Recurrent Optimization	Corentin Tallec, Yann Ollivier
Measuring the Intrinsic Dimension of Objective Landscapes	Chunyuan Li, Heerad Farkhoor, Rosanne Liu, Jason Yosinski
Memorization Precedes Generation: Learning Unsupervised GANs with Memory Networks	Youngjin Kim, Minjung Kim, Gunhee Kim
Stochastic Activation Pruning for Robust Adversarial Defense	Guneet S. Dhillon, Kamyar Azizzadenesheli, Zachary C. Lipton, Jeremy D. Bernstein, Jean Kossaifi, Aran Khanna, Animashree Anandkumar
Sparse Persistent RNNs: Squeezing Large Recurrent Networks On-Chip	Feiwen Zhu, Jeff Pool, Michael Andersch, Jeremy Appleyard, Fung Xie
GANITE: Estimation of Individualized Treatment Effects using Generative Adversarial Nets	Jinsung Yoon, James Jordon, Mihaela van der Schaar
Thermometer Encoding: One Hot Way To Resist Adversarial Examples	Jacob Buckman, Aurko Roy, Colin Raffel, Ian Goodfellow
Trust-PCL: An Off-Policy Trust Region Method for Continuous Control	Ofir Nachum, Mohammad Norouzi, Kelvin Xu, Dale Schuurmans
Stochastic Variational Video Prediction	Mohammad Babaeizadeh, Chelsea Finn, Dumitru Erhan, Roy H. Campbell, Sergey Levine
Towards Image Understanding from Deep Compression Without Decoding	Robert Torfason, Fabian Mentzer, Eirikur Agustsson, Michael Tschannen, Radu Timofte, Luc Van Gool
Automatically Inferring Data Quality for Spatiotemporal Forecasting	Sungyong Seo, Arash Mohegh, George Ban-Weiss, Yan Liu
Towards better understanding of gradient-based attribution methods for Deep Neural Networks	Marco Ancona, Enea Ceolini, Cengiz Oztireli, Markus Gross
Countering Adversarial Images using Input Transformations	Chuan Guo, Mayank Rana, Moustapha Cisse, Laurens van der Maaten
Skip RNN: Learning to Skip State Updates in Recurrent Neural Networks	Victor Campos, Brendan Jou, Xavier Giro-i-Nieto, Jordi Torres, Shih-Fu Chang
Modular Continual Learning in a Unified Visual Environment	Kevin T. Feigelis, Blue Sheffer, Daniel L. K. Yamins
Twin Networks: Matching the Future for Sequence Generation	Dmitriy Serdyuk, Nan Rosemary Ke, Alessandro Sordoni, Adam Trischler, Chris Pal, Yoshua Bengio
Interpretable Counting for Visual Question Answering	Alexander Trott, Caiming Xiong, Richard Socher
Interactive Grounded Language Acquisition and Generalization in a 2D World	Haonan Yu, Haichao Zhang, Wei Xu
Emergent Complexity via Multi-Agent Competition	Trapit Bansal, Jakub Pachocki, Szymon Sidor, Ilya Sutskever, Igor Mordatch
Universal Agent for Disentangling Environments and Tasks	Jiayuan Mao, Honghua Dong, Joseph J. Lim
Residual Connections Encourage Iterative Inference	Stanis??aw Jastrzebski, Devansh Arpit, Nicolas Ballas, Vikas Verma, Tong Che, Yoshua Bengio
Emergent Communication through Negotiation	Kris Cao, Angeliki Lazaridou, Marc Lanctot, Joel Z Leibo, Karl Tuyls, Stephen Clark
Semi-parametric topological memory for navigation	Nikolay Savinov, Alexey Dosovitskiy, Vladlen Koltun
Learning to Count Objects in Natural Images for Visual Question Answering	Yan Zhang, Jonathon Hare, Adam Prugel-Bennett
i-RevNet: Deep Invertible Networks	Jorn-Henrik Jacobsen, Arnold W.M. Smeulders, Edouard Oyallon
Evaluating the Robustness of Neural Networks: An Extreme Value Theory Approach	Tsui-Wei Weng*, Huan Zhang*, Pin-Yu Chen, Jinfeng Yi, Dong Su, Yupeng Gao, Cho-Jui Hsieh, Luca Daniel
HexaConv	Emiel Hoogeboom, Jorn W.T. Peters, Taco S. Cohen, Max Welling
Towards Deep Learning Models Resistant to Adversarial Attacks	Aleksander Madry, Aleksandar Makelov, Ludwig Schmidt, Dimitris Tsipras, Adrian Vladu
Deep Learning for Physical Processes: Incorporating Prior Scientific Knowledge	Emmanuel de Bezenac, Arthur Pajot, Patrick Gallinari
Communication Algorithms via Deep Learning	Hyeji Kim, Yihan Jiang, Ranvir B. Rana, Sreeram Kannan, Sewoong Oh, Pramod Viswanath
Simulating Action Dynamics with Neural Process Networks	Antoine Bosselut, Omer Levy, Ari Holtzman, Corin Ennis, Dieter Fox, Yejin Choi
Unsupervised Cipher Cracking Using Discrete GANs	Aidan N. Gomez, Sicong Huang, Ivan Zhang, Bryan M. Li, Muhammad Osama, Lukasz Kaiser
Neural Speed Reading via Skim-RNN	Minjoon Seo, Sewon Min, Ali Farhadi, Hannaneh Hajishirzi
Multi-level Residual Networks from Dynamical Systems View	Bo Chang, Lili Meng, Eldad Haber, Frederick Tung, David Begert
Towards Neural Phrase-based Machine Translation	Po-Sen Huang, Chong Wang, Sitao Huang, Dengyong Zhou, Li Deng
On the State of the Art of Evaluation in Neural Language Models	Gabor Melis, Chris Dyer, Phil Blunsom
Memory-based Parameter Adaptation	Pablo Sprechmann, Siddhant M. Jayakumar, Jack W. Rae, Alexander Pritzel, Adria Puigdomenech Badia, Benigno Uria, Oriol Vinyals, Demis Hassabis, Razvan Pascanu, Charles Blundell
Initialization matters: Orthogonal Predictive State Recurrent Neural Networks	Krzysztof Choromanski, Carlton Downey, Byron Boots
PixelDefend: Leveraging Generative Models to Understand and Defend against Adversarial Examples	Yang Song, Taesup Kim, Sebastian Nowozin, Stefano Ermon, Nate Kushman
Certified Defenses against Adversarial Examples	Aditi Raghunathan, Jacob Steinhardt, Percy Liang
Defense-GAN: Protecting Classifiers Against Adversarial Attacks Using Generative Models	Pouya Samangouei, Maya Kabkab, Rama Chellappa
Ensemble Adversarial Training: Attacks and Defenses	Florian Tramer, Alexey Kurakin, Nicolas Papernot, Ian Goodfellow, Dan Boneh, Patrick McDaniel
Fraternal Dropout	Konrad Zolna, Devansh Arpit, Dendi Suhubdy, Yoshua Bengio
Can recurrent neural networks warp time?	Corentin Tallec, Yann Ollivier
Parallelizing Linear Recurrent Neural Nets Over Sequence Length	Eric Martin, Chris Cundy
Attacking Binarized Neural Networks	Angus Galloway, Graham W. Taylor, Medhat Moussa
Depthwise Separable Convolutions for Neural Machine Translation	Lukasz Kaiser, Aidan N. Gomez, Francois Chollet
Noisy Networks For Exploration	Meire Fortunato, Mohammad Gheshlaghi Azar, Bilal Piot, Jacob Menick, Matteo Hessel, Ian Osband, Alex Graves, Volodymyr Mnih, Remi Munos, Demis Hassabis, Olivier Pietquin, Charles Blundell, Shane Legg
A Hierarchical Model for Device Placement	Azalia Mirhoseini, Anna Goldie, Hieu Pham, Benoit Steiner, Quoc V. Le, Jeff Dean
Deep Autoencoding Gaussian Mixture Model for Unsupervised Anomaly Detection	Bo Zong, Qi Song, Martin Renqiang Min, Wei Cheng, Cristian Lumezanu, Daeki Cho, Haifeng Chen
Learning Discrete Weights Using the Local Reparameterization Trick	Oran Shayer, Dan Levi, Ethan Fetaya
Deep Rewiring: Training very sparse deep networks	Guillaume Bellec, David Kappel, Wolfgang Maass, Robert Legenstein
Quantitatively Evaluating GANs With Divergences Proposed for Training	Daniel Jiwoong Im, He Ma, Graham W. Taylor, Kristin Branson
Improving GAN Training via Binarized Representation Entropy (BRE) Regularization	Yanshuai Cao, Gavin Weiguang Ding, Kry Yik-Chau Lui, Ruitong Huang
Generative networks as inverse problems with Scattering transforms	Tomas Angles, Stephane Mallat
Critical Percolation as a Framework to Analyze the Training of Deep Networks	Zohar Ringel, Rodrigo Andrade de Bem
On the Expressive Power of Overlapping Architectures of Deep Learning	Or Sharir, Amnon Shashua
Rethinking the Smaller-Norm-Less-Informative Assumption in Channel Pruning of Convolution Layers	Jianbo Ye, Xin Lu, Zhe Lin, James Z. Wang
Diffusion Convolutional Recurrent Neural Network: Data-Driven Traffic Forecasting	Yaguang Li, Rose Yu, Cyrus Shahabi, Yan Liu
Simulated+Unsupervised Learning With Adaptive Data Generation and Bidirectional Mappings	Kangwook Lee, Hoon Kim, Changho Suh
Relational Neural Expectation Maximization: Unsupervised Discovery of Objects and their Interactions	Sjoerd van Steenkiste, Michael Chang, Klaus Greff, Jurgen Schmidhuber
Generative Models of Visually Grounded Imagination	Ramakrishna Vedantam, Ian Fischer, Jonathan Huang, Kevin Murphy
Few-shot Autoregressive Density Estimation: Towards Learning to Learn Distributions	Scott Reed, Yutian Chen, Thomas Paine, Aaron van den Oord, S. M. Ali Eslami, Danilo Rezende, Oriol Vinyals, Nando de Freitas
Compositional Obverter Communication Learning from Raw Visual Input	Edward Choi, Angeliki Lazaridou, Nando de Freitas
SCAN: Learning Hierarchical Compositional Visual Concepts	Irina Higgins, Nicolas Sonnerat, Loic Matthey, Arka Pal, Christopher P Burgess, Matko Bo?njak, Murray Shanahan, Matthew Botvinick, Demis Hassabis, Alexander Lerchner
Hierarchical Density Order Embeddings	Ben Athiwaratkun, Andrew Gordon Wilson
Identifying Analogies Across Domains	Yedid Hoshen, Lior Wolf
Emergence of grid-like representations by training recurrent neural networks to perform spatial localization	Christopher J. Cueva, Xue-Xin Wei
Learning a neural response metric for retinal prosthesis	Nishal P Shah, Sasidhar Madugula, EJ Chichilnisky, Yoram Singer, Jonathon Shlens
Few-Shot Learning with Graph Neural Networks	Victor Garcia Satorras, Joan Bruna Estrach
Semantically Decomposing the Latent Spaces of Generative Adversarial Networks	Chris Donahue, Zachary C. Lipton, Akshay Balsubramani, Julian McAuley
A Framework for the Quantitative Evaluation of Disentangled Representations	Cian Eastwood, Christopher K. I. Williams
Meta-Learning for Semi-Supervised Few-Shot Classification	Mengye Ren, Eleni Triantafillou, Sachin Ravi, Jake Snell, Kevin Swersky, Joshua B. Tenenbaum, Hugo Larochelle, Richard S. Zemel
A DIRT-T Approach to Unsupervised Domain Adaptation	Rui Shu, Hung Bui, Hirokazu Narui, Stefano Ermon
Generalizing Across Domains via Cross-Gradient Training	Shiv Shankar*, Vihari Piratla*, Soumen Chakrabarti, Siddhartha Chaudhuri, Preethi Jyothi, Sunita Sarawagi
Learning to cluster in order to transfer across domains and tasks	Yen-Chang Hsu, Zhaoyang Lv, Zsolt Kira
Deep Complex Networks	Chiheb Trabelsi, Olexa Bilaniuk, Ying Zhang, Dmitriy Serdyuk, Sandeep Subramanian, Joao Felipe Santos, Soroush Mehri, Negar Rostamzadeh, Yoshua Bengio, Christopher J Pal
Skip Connections Eliminate Singularities	Emin Orhan, Xaq Pitkow
Bi-Directional Block Self-Attention for Fast and Memory-Efficient Sequence Modeling	Tao Shen, Tianyi Zhou, Guodong Long, Jing Jiang, Chengqi Zhang
Routing Networks: Adaptive Selection of Non-Linear Functions for Multi-Task Learning	Clemens Rosenbaum, Tim Klinger, Matthew Riemer
Wavelet Pooling for Convolutional Neural Networks	Travis Williams, Robert Li
FearNet: Brain-Inspired Model for Incremental Learning	Ronald Kemker, Christopher Kanan
Do GANs learn the distribution? Some Theory and Empirics	Sanjeev Arora, Andrej Risteski, Yi Zhang
Towards Reverse-Engineering Black-Box Neural Networks	Seong Joon Oh, Max Augustin, Mario Fritz, Bernt Schiele
Understanding Deep Neural Networks with Rectified Linear Units	Raman Arora, Amitabh Basu, Poorya Mianjy, Anirbit Mukherjee
Training wide residual networks for deployment using a single bit for each weight	Mark D. McDonnell
Learn to Pay Attention	Saumya Jetley, Nicholas A. Lord, Namhoon Lee, Philip H. S. Torr
Monotonic Chunkwise Attention	Chung-Cheng Chiu*, Colin Raffel*
Recasting Gradient-Based Meta-Learning as Hierarchical Bayes	Erin Grant, Chelsea Finn, Sergey Levine, Trevor Darrell, Thomas Griffiths
Don't Decay the Learning Rate, Increase the Batch Size	Samuel L. Smith, Pieter-Jan Kindermans, Chris Ying, Quoc V. Le
Kronecker-factored Curvature Approximations for Recurrent Neural Networks	James Martens, Jimmy Ba, Matt Johnson
Proximal Backpropagation	Thomas Frerix, Thomas Mollenhoff, Michael Moeller, Daniel Cremers
Neumann Optimizer: A Practical Optimization Algorithm for Deep Neural Networks	Shankar Krishnan, Ying Xiao, Rif. A. Saurous
SGD Learns Over-parameterized Networks that Provably Generalize on Linearly Separable Data	Alon Brutzkus, Amir Globerson, Eran Malach, Shai Shalev-Shwartz
A PAC-Bayesian Approach to Spectrally-Normalized Margin Bounds for Neural Networks	Behnam Neyshabur, Srinadh Bhojanapalli, Nathan Srebro
On the importance of single directions for generalization	Ari S. Morcos, David G.T. Barrett, Neil C. Rabinowitz, Matthew Botvinick
The Implicit Bias of Gradient Descent on Separable Data	Daniel Soudry, Elad Hoffer, Mor Shpigel Nacson, Nathan Srebro
Many Paths to Equilibrium: GANs Do Not Need to Decrease a Divergence At Every Step	William Fedus*, Mihaela Rosca*, Balaji Lakshminarayanan, Andrew M. Dai, Shakir Mohamed, Ian Goodfellow
Adaptive Dropout with Rademacher Complexity Regularization	Ke Zhai, Huan Wang
A Bayesian Perspective on Generalization and Stochastic Gradient Descent	Samuel L. Smith and Quoc V. Le
Implicit Causal Models for Genome-wide Association Studies	Dustin Tran, David M. Blei
Sensitivity and Generalization in Neural Networks: an Empirical Study	Roman Novak, Yasaman Bahri, Daniel A. Abolafia, Jeffrey Pennington, Jascha Sohl-Dickstein
Regularizing and Optimizing LSTM Language Models	Stephen Merity, Nitish Shirish Keskar, Richard Socher
DCN+: Mixed Objective And Deep Residual Coattention for Question Answering	Caiming Xiong, Victor Zhong, Richard Socher
Word translation without parallel data	Guillaume Lample, Alexis Conneau, Marc'Aurelio Ranzato, Ludovic Denoyer, Herve Jegou
All-but-the-Top: Simple and Effective Postprocessing for Word Representations	Jiaqi Mu, Pramod Viswanath
Learning General Purpose Distributed Sentence Representations via Large Scale Multi-task Learning	Sandeep Subramanian, Adam Trischler, Yoshua Bengio, Christopher J Pal
Natural Language Inference over Interaction Space	Yichen Gong, Heng Luo, Jian Zhang
Multi-Task Learning for Document Ranking and Query Suggestion	Wasi Uddin Ahmad, Kai-Wei Chang, Hongning Wang
Distributed Fine-tuning of Language Models on Private Data	Vadim Popov, Mikhail Kudinov, Irina Piontkovskaya, Petr Vytovtov, Alex Nevidomsky
Intrinsic Motivation and Automatic Curricula via Asymmetric Self-Play	Sainbayar Sukhbaatar, Zeming Lin, Ilya Kostrikov, Gabriel Synnaeve, Arthur Szlam, Rob Fergus
Reinforcement Learning Algorithm Selection	Romain Laroche, Raphael Feraud
Leave no Trace: Learning to Reset for Safe and Autonomous Reinforcement Learning	Benjamin Eysenbach, Shixiang Gu, Julian Ibarz, Sergey Levine
Consequentialist conditional cooperation in social dilemmas with imperfect information	Alexander Peysakhovich, Adam Lerer
Can Neural Networks Understand Logical Entailment?	Richard Evans, David Saxton, David Amos, Pushmeet Kohli, Edward Grefenstette
Cascade Adversarial Machine Learning Regularized with a Unified Embedding	Taesik Na, Jong Hwan Ko, Saibal Mukhopadhyay
Mitigating Adversarial Effects Through Randomization	Cihang Xie, Jianyu Wang, Zhishuai Zhang, Zhou Ren, Alan Yuille
Decision Boundary Analysis of Adversarial Examples	Warren He, Bo Li, Dawn Song
Matrix capsules with EM routing	Geoffrey E Hinton, Sara Sabour, Nicholas Frosst
CausalGAN: Learning Causal Implicit Generative Models with Adversarial Training	Murat Kocaoglu, Christopher Snyder, Alexandros G. Dimakis, Sriram Vishwanath
Learning Wasserstein Embeddings	Nicolas Courty, Remi Flamary, Melanie Ducoffe
TRAINING GENERATIVE ADVERSARIAL NETWORKS VIA PRIMAL-DUAL SUBGRADIENT METHODS: A LAGRANGIAN PERSPECTIVE ON GAN	Xu Chen, Jiang Wang, Hao Ge
Activation Maximization Generative Adversarial Nets	Zhiming Zhou, Han Cai, Shu Rong, Yuxuan Song, Kan Ren, Weinan Zhang, Jun Wang, Yong Yu
Coulomb GANs: Provably Optimal Nash Equilibria via Potential Fields	Thomas Unterthiner, Bernhard Nessler, Calvin Seward, Gunter Klambauer, Martin Heusel, Hubert Ramsauer, Sepp Hochreiter
Improving the Improved Training of Wasserstein GANs: A Consistency Term and Its Dual Effect	Xiang Wei, Boqing Gong, Zixia Liu, Wei Lu, Liqiang Wang
FusionNet: Fusing via Fully-aware Attention with Application to Machine Comprehension	Hsin-Yuan Huang, Chenguang Zhu, Yelong Shen, Weizhu Chen
Neural Language Modeling by Jointly Learning Syntax and Lexicon	Yikang Shen, Zhouhan Lin, Chin-wei Huang, Aaron Courville
Learning Intrinsic Sparse Structures within Long Short-Term Memory	Wei Wen, Yuxiong He, Samyam Rajbhandari, Minjia Zhang, Wenhan Wang, Fang Liu, Bin Hu, Yiran Chen, Hai Li
Deep Active Learning for Named Entity Recognition	Yanyao Shen, Hyokun Yun, Zachary C. Lipton, Yakov Kronrod, Animashree Anandkumar
Go for a Walk and Arrive at the Answer: Reasoning Over Paths in Knowledge Bases using Reinforcement Learning	Rajarshi Das, Shehzaad Dhuliawala, Manzil Zaheer, Luke Vilnis, Ishan Durugkar, Akshay Krishnamurthy, Alex Smola, Andrew McCallum
Lifelong Learning with Dynamically Expandable Networks	Jaehong Yoon, Eunho Yang, Jeongtae Lee, Sung Ju Hwang
The Role of Minimal Complexity Functions in Unsupervised Learning of Semantic Mappings	Tomer Galanti, Lior Wolf, Sagie Benaim
Dynamic Neural Program Embeddings for Program Repair	Ke Wang, Rishabh Singh, Zhendong Su
Compositional Attention Networks for Machine Reasoning	Drew A. Hudson, Christopher D. Manning
Beyond Shared Hierarchies: Deep Multitask Learning through Soft Layer Ordering	Elliot Meyerson, Risto Miikkulainen
Hierarchical Representations for Efficient Architecture Search	Hanxiao Liu, Karen Simonyan, Oriol Vinyals, Chrisantha Fernando, Koray Kavukcuoglu
Reinforcement Learning on Web Interfaces using Workflow-Guided Exploration	Evan Zheran Liu, Kelvin Guu, Panupong Pasupat, Tianlin Shi, Percy Liang
Combining Symbolic Expressions and Black-box Function Evaluations in Neural Programs	Forough Arabshahi, Sameer Singh, Animashree Anandkumar
Scalable Private Learning with PATE	Nicolas Papernot, Shuang Song, Ilya Mironov, Ananth Raghunathan, Kunal Talwar, Ulfar Erlingsson
Active Learning for Convolutional Neural Networks: A Core-Set Approach	Ozan Sener, Silvio Savarese
Loss-aware Weight Quantization of Deep Networks	Lu Hou, James T. Kwok
Global Optimality Conditions for Deep Neural Networks	Chulhee Yun, Suvrit Sra, Ali Jadbabaie
SpectralNet: Spectral Clustering using Deep Neural Networks	Uri Shaham, Kelly Stanton, Henry Li, Ronen Basri, Boaz Nadler, Yuval Kluger
Not-So-Random Features	Brian Bullins, Cyril Zhang, Yi Zhang
Learning how to explain neural networks: PatternNet and PatternAttribution	Pieter-Jan Kindermans, Kristof T. Schutt, Maximilian Alber, Klaus-Robert Muller, Dumitru Erhan, Been Kim, Sven Dahne
Detecting Statistical Interactions from Neural Network Weights	Michael Tsang, Dehua Cheng, Yan Liu
Deep Gaussian Embedding of Graphs: Unsupervised Inductive Learning via Ranking	Aleksandar Bojchevski, Stephan Gunnemann
Generating Natural Adversarial Examples	Zhengli Zhao, Dheeru Dua, Sameer Singh
Spatially Transformed Adversarial Examples	Chaowei Xiao, Jun-Yan Zhu, Bo Li, Warren He, Mingyan Liu, Dawn Song
Predicting Floor-Level for 911 Calls with Neural Networks and Smartphone Sensor Data	William Falcon, Henning Schulzrinne
Understanding image motion with group representations	Andrew Jaegle, Stephen Phillips, Daphne Ippolito, Kostas Daniilidis
Learning Awareness Models	Brandon Amos, Laurent Dinh, Serkan Cabi, Thomas Rothorl, Sergio Gomez Colmenarejo, Alistair Muldal, Tom Erez, Yuval Tassa, Nando de Freitas, Misha Denil
Backpropagation through the Void: Optimizing control variates for black-box gradient estimation	Will Grathwohl, Dami Choi, Yuhuai Wu, Geoff Roeder, David Duvenaud
On Unifying Deep Generative Models	Zhiting Hu, Zichao Yang, Ruslan Salakhutdinov, Eric P. Xing
Debiasing Evidence Approximations: On Importance-weighted Autoencoders and Jackknife Variational Inference	Sebastian Nowozin
Learning a Generative Model for Validity in Complex Discrete Structures	Dave Janz, Jos van der Westhuizen, Brooks Paige, Matt Kusner, Jose Miguel Hernandez-Lobato
Boundary Seeking GANs	R Devon Hjelm, Athul Paul Jacob, Adam Trischler, Gerry Che, Kyunghyun Cho, Yoshua Bengio
Learning Sparse Latent Representations with the Deep Copula Information Bottleneck	Aleksander Wieczorek*, Mario Wieser*, Damian Murezzan, Volker Roth
WHAI: Weibull Hybrid Autoencoding Inference for Deep Topic Modeling	Hao Zhang, Bo Chen, Dandan Guo, Mingyuan Zhou
Understanding Short-Horizon Bias in Stochastic Meta-Optimization	Yuhuai Wu, Mengye Ren, Renjie Liao, Roger Grosse.
Self-ensembling for visual domain adaptation	Geoff French, Michal Mackiewicz, Mark Fisher
Gradient Estimators for Implicit Models	Yingzhen Li, Richard E. Turner
Learning to Multi-Task by Active Sampling	Sahil Sharma*, Ashutosh Kumar Jha*, Parikshit S Hegde, Balaraman Ravindran
Learning Robust Rewards with Adverserial Inverse Reinforcement Learning	Justin Fu, Katie Luo, Sergey Levine
A Simple Neural Attentive Meta-Learner	Nikhil Mishra, Mostafa Rohaninejad, Xi Chen, Pieter Abbeel
Deep Learning and Quantum Entanglement: Fundamental Connections with Implications to Network Design	Yoav Levine, David Yakira, Nadav Cohen, Amnon Shashua
Towards Synthesizing Complex Programs From Input-Output Examples	Xinyun Chen, Chang Liu, Dawn Song
Expressive power of recurrent neural networks	Valentin Khrulkov, Alexander Novikov, Ivan Oseledets
Improving the Universality and Learnability of Neural Programmer-Interpreters with Combinator Abstraction	Da Xiao, Jo-Yu Liao, Xingyuan Yuan
An image representation based convolutional network for DNA classification	Bojian Yin, Marleen Balvert, Davide Zambrano, Alexander Schoenhuth, Sander Bohte
SMASH: One-Shot Model Architecture Search through HyperNetworks	Andrew Brock, Theo Lim, J.M. Ritchie, Nick Weston
Parameter Space Noise for Exploration	Matthias Plappert, Rein Houthooft, Prafulla Dhariwal, Szymon Sidor, Richard Y. Chen, Xi Chen, Tamim Asfour, Pieter Abbeel, Marcin Andrychowicz
Synthesizing realistic neural population activity patterns using Generative Adversarial Networks	Manuel Molano-Mazon, Arno Onken, Eugenio Piasini*, Stefano Panzeri*
Auto-Encoding Sequential Monte Carlo	Tuan Anh Le, Maximilian Igl, Tom Rainforth, Tom Jin, Frank Wood
Learning to Teach	Yang Fan, Fei Tian, Tao Qin, Xiang-Yang Li, Tie-Yan Liu
PixelNN: Example-based Image Synthesis	Aayush Bansal, Yaser Sheikh, Deva Ramanan
Non-Autoregressive Neural Machine Translation	Jiatao Gu, James Bradbury, Caiming Xiong, Victor O.K. Li, Richard Socher
Deep Voice 3: Scaling Text-to-Speech with Convolutional Sequence Learning	Wei Ping, Kainan Peng, Andrew Gibiansky, Sercan O. Arik, Ajay Kannan, Sharan Narang, Jonathan Raiman, John Miller
mixup: Beyond Empirical Risk Minimization	Hongyi Zhang, Moustapha Cisse, Yann N. Dauphin, David Lopez-Paz
TD or not TD: Analyzing the Role of Temporal Differencing in Deep Reinforcement Learning	Artemij Amiranashvili, Alexey Dosovitskiy, Vladlen Koltun, Thomas Brox
DORA The Explorer: Directed Outreaching Reinforcement Action-Selection	Lior Fox, Leshem Choshen, Yonatan Loewenstein
Temporal Difference Models: Model-Free Deep RL for Model-Based Control	Vitchyr Pong*, Shixiang Gu*, Murtaza Dalal, Sergey Levine
TreeQN and ATreeC: Differentiable Tree-Structured Models for Deep Reinforcement Learning	Gregory Farquhar, Tim Rocktaschel, Maximilian Igl, Shimon Whiteson
Alternating Multi-bit Quantization for Recurrent Neural Networks	Chen Xu, Jianqiang Yao, Zhouchen Lin, Wenwu Ou, Yuanbin Cao, Zhirong Wang, Hongbin Zha
Residual Loss Prediction: Reinforcement Learning With No Incremental Feedback	Hal Daume III, John Langford, Amr Sharaf
Adaptive Quantization of Neural Networks	Soroosh Khoram, Jing Li
Boosting the Actor with Dual Critic	Bo Dai, Albert Shaw, Niao He, Lihong Li, Le Song
Guide Actor-Critic for Continuous Control	Voot Tangkaratt, Abbas Abdolmaleki, Masashi Sugiyama
Policy Optimization by Genetic Distillation	Tanmay Gangwani, Jian Peng
When is a Convolutional Filter Easy to Learn?	Simon S. Du, Jason D. Lee, Yuandong Tian
Online Learning Rate Adaptation with Hypergradient Descent	Atilim Gunes Baydin, Robert Cornish, David Martinez Rubio, Mark Schmidt, Frank Wood
Stochastic gradient descent performs variational inference, converges to limit cycles for deep networks	Pratik Chaudhari, Stefano Soatto
Robustness of Classifiers to Universal Perturbations: A Geometric Perspective	Seyed-Mohsen Moosavi-Dezfooli, Alhussein Fawzi, Omar Fawzi, Pascal Frossard, Stefano Soatto
On the regularization of Wasserstein GANs	Henning Petzka, Asja Fischer, Denis Lukovnikov
Eigenoption Discovery through the Deep Successor Representation	Marlos C. Machado, Clemens Rosenbaum, Xiaoxiao Guo, Miao Liu, Gerald Tesauro, Murray Campbell
Neural Map: Structured Memory for Deep Reinforcement Learning	Emilio Parisotto, Ruslan Salakhutdinov
Active Neural Localization	Devendra Singh Chaplot, Emilio Parisotto, Ruslan Salakhutdinov
Overcoming Catastrophic Interference using Conceptor-Aided Backpropagation	Xu He, Herbert Jaeger
Memory Augmented Control Networks	Arbaaz Khan, Clark Zhang, Nikolay Atanasov, Konstantinos Karydis, Vijay Kumar, Daniel D. Lee
Progressive Reinforcement Learning with Distillation for Multi-Skilled Motion Control	Glen Berseth, Cheng Xie, Paul Cernek, Michiel Van de Panne
N2N learning: Network to Network Compression via Policy Gradient Reinforcement Learning	Anubhav Ashok, Nicholas Rhinehart, Fares Beainy, Kris M. Kitani
Hierarchical and Interpretable Skill Acquisition in Multi-task Reinforcement Learning	Tianmin Shu, Caiming Xiong, Richard Socher
Divide-and-Conquer Reinforcement Learning	Dibya Ghosh, Avi Singh, Aravind Rajeswaran, Vikash Kumar, Sergey Levine
A Compressed Sensing View of Unsupervised Text Embeddings, Bag-of-n-Grams, and LSTMs	Sanjeev Arora, Mikhail Khodak, Nikunj Saunshi, Kiran Vodrahalli
A New Method of Region Embedding for Text Classification	chao qiao, bo huang, guocheng niu, daren li, daxiang dong, wei he, dianhai yu, hua wu
Fix your classifier: the marginal value of training the last weight layer	Elad Hoffer, Itay Hubara, Daniel Soudry
Multi-Mention Learning for Reading Comprehension with Neural Cascades	Swabha Swayamdipta, Ankur P. Parikh, Tom Kwiatkowski
Deep Sensing: Active Sensing using Multi-directional Recurrent Neural Networks	Jinsung Yoon, William R. Zame, Mihaela van der Schaar
Temporally Efficient Deep Learning with Spikes	Peter O'Connor, Efstratios Gavves, Matthias Reisser, Max Welling
Variational Network Quantization	Jan Achterhold, Jan Mathias Koehler, Anke Schmeink, Tim Genewein
Training GANs with Optimism	Constantinos Daskalakis, Andrew Ilyas, Vasilis Syrgkanis, Haoyang Zeng
Sobolev GAN	Youssef Mroueh, Chun-Liang Li, Tom Sercu, Anant Raj, Yu Cheng
Learning From Noisy Singly-labeled Data	Ashish Khetan, Zachary C. Lipton, Animashree Anandkumar
Learning Sparse Neural Networks through L_0 Regularization	Christos Louizos, Max Welling, Diederik P. Kingma
Variational Continual Learning	Cuong V. Nguyen, Yingzhen Li, Thang D. Bui, Richard E. Turner
Gaussian Process Behaviour in Wide Deep Neural Networks	Alexander G. de G. Matthews, Jiri Hron, Mark Rowland, Richard E. Turner, Zoubin Ghahramani
Mixed Precision Training of Convolutional Neural Networks using Integer Operations	Dipankar Das, Naveen Mellempudi, Dheevatsa Mudigere, Dhiraj Kalamkar, Sasikanth Avancha, Kunal Banerjee, Srinivas Sridharan, Karthik Vaidyanathan, Bharat Kaul, Evangelos Georganas, Alexander Heinecke, Pradeep Dubey, Jesus Corbal, Nikita Shustrov, Roma Dubtsov, Evarist Fomenko, Vadim Pirogov
Memory Architectures in Recurrent Neural Network Language Models	Dani Yogatama, Yishu Miao, Gabor Melis, Wang Ling, Adhiguna Kuncoro, Chris Dyer, Phil Blunsom
On the Information Bottleneck Theory of Deep Learning	Andrew Michael Saxe, Yamini Bansal, Joel Dapello, Madhu Advani, Artemy Kolchinsky, Brendan Daniel Tracey, David Daniel Cox
