Learning Continuous Semantic Representations of Symbolic Expressions	Miltiadis Allamanis, Pankajan Chanthirasegaran, Pushmeet Kohli, Charles Sutton
Discovering objects and their relations from entangled scene representations	David Raposo, Adam Santoro, David Barrett, Razvan Pascanu, Timothy Lillicrap, Peter Battaglia
Towards an automatic Turing test: Learning to evaluate dialogue responses	Ryan Lowe, Michael Noseworthy, Iulian V. Serban, Nicolas Angelard-Gontier, Yoshua Bengio, Joelle Pineau
Gated Multimodal Units for Information Fusion	John Arevalo, Thamar Solorio, Manuel Montes-y-Gómez, Fabio A. González
Unsupervised Perceptual Rewards for Imitation Learning	Pierre Sermanet, Kelvin Xu, Sergey Levine
A Theoretical Framework for Robustness of (Deep) Classifiers against Adversarial Samples	Beilun Wang, Ji Gao, Yanjun Qi
Lifelong Perceptual Programming By Example	Alexander L. Gaunt, Marc Brockschmidt, Nate Kushman, Daniel Tarlow
Automated Generation of Multilingual Clusters for the Evaluation of Distributed Representations	Philip Blair, Yuval Merhav, Joel Barry
Shift Aggregate Extract Networks	Francesco Orsini, Daniele Baracchi, Paolo Frasconi
Programming With a Differentiable Forth Interpreter	Matko Bošnjak, Tim Rocktäschel, Jason Naradowsky, Sebastian Riedel
Bit-Pragmatic Deep Neural Network Computing	Jorge Albericio, Patrick Judd, Alberto Delmas, Sayeh Sharify, Andreas Moshovos
Recursive Regression with Neural Networks: Approximating the HJI PDE Solution	Vicenç Rubies Royo, Claire Tomlin
Nonparametrically Learning Activation Functions in Deep Neural Nets	Carson Eisenach, Zhaoran Wang, Han Liu
Generalizable Features From Unsupervised Learning	Mehdi Mirza, Aaron Courville, Yoshua Bengio
Deep Learning with Sets and Point Clouds	Siamak Ravanbakhsh, Jeff Schneider, Barnabas Poczos
Exponential Machines	Alexander Novikov, Mikhail Trofimov, Ivan Oseledets
Song From PI: A Musically Plausible Network for Pop Music Generation	Hang Chu, Raquel Urtasun, Sanja Fidler
Learning to Discover Sparse Graphical Models	Eugene Belilovsky, Kyle Kastner, Gael Varoquaux, Matthew B. Blaschko
Learning to Draw Samples: With Application to Amortized MLE for Generative Adversarial Learning	Dilin Wang, Qiang Liu
Recurrent Normalization Propagation	César Laurent, Nicolas Ballas, Pascal Vincent
Generating Interpretable Images with Controllable Structure	Scott Reed, Aäron van den Oord, Nal Kalchbrenner, Victor Bapst, Matt Botvinick, Nando de Freitas
Fast Chirplet Transform to Enhance CNN Machine Listening - Validation on Animal calls and Speech	Herve Glotin, Julien Ricard, Randall Balestriero
Symmetry-Breaking Convergence Analysis of Certain Two-layered Neural Networks with ReLU nonlinearity	Yuandong Tian
Efficient Softmax Approximation for GPUs	Édouard Grave, Armand Joulin, Moustapha Cissé, David Grangier, Hervé Jégou
Dataset Augmentation in Feature Space	Terrance DeVries, Graham W. Taylor
Online Structure Learning for Sum-Product Networks with Gaussian Leaves	Wilson Hsu, Agastya Kalra, Pascal Poupart
Neural Taylor Approximations: Convergence and Exploration in Rectifier Networks	David Balduzzi, Brian McWilliams, Tony Butler-Yeoman
Multiplicative LSTM for sequence modelling	Ben Krause, Iain Murray, Steve Renals, Liang Lu
Neural Functional Programming	John K. Feser, Marc Brockschmidt, Alexander L. Gaunt, Daniel Tarlow
Tuning Recurrent Neural Networks with Reinforcement Learning	Natasha Jaques, Shixiang Gu, Richard E. Turner, Douglas Eck
Perception Updating Networks: On architectural constraints for interpretable video generative models	Eder Santana, Jose C Principe
Neural Data Filter for Bootstrapping Stochastic Gradient Descent	Yang Fan, Fei Tian, Tao Qin, Tie-Yan Liu
Surprise-Based Intrinsic Motivation for Deep Reinforcement Learning	Joshua Achiam, Shankar Sastry
Learning in Implicit Generative Models	Shakir Mohamed, Balaji Lakshminarayanan
Adaptive Feature Abstraction for Translating Video to Language	Yunchen Pu, Martin Renqiang Min, Zhe Gan, Lawrence Carin
On Robust Concepts and Small Neural Nets	Amit Deshpande, Sushrut Karmalkar
RenderGAN: Generating Realistic Labeled Data	Leon Sixt, Benjamin Wild, Tim Landgraf
Semi-supervised deep learning by metric embedding	Elad Hoffer, Nir Ailon
Modularized Morphing of Neural Networks	Tao Wei, Changhu Wang, Chang Wen Chen
Short and Deep: Sketching and Neural Networks	Amit Daniely, Nevena Lazic, Yoram Singer, Kunal Talwar
Modular Multitask Reinforcement Learning with Policy Sketches	Jacob Andreas, Dan Klein, Sergey Levine
Development of JavaScript-based deep learning platform and application to distributed training	Masatoshi Hidaka, Ken Miura, Tatsuya Harada
A Differentiable Physics Engine for Deep Learning in Robotics	Jonas Degrave, Michiel Hermans, Joni Dambre, Francis wyffels
Compositional Kernel Machines	Robert Gens, Pedro Domingos
Extrapolation and learning equations	Georg Martius, Christoph H. Lampert
Adversarial examples in the physical world	Alexey Kurakin, Ian J. Goodfellow, Samy Bengio
Charged Point Normalization: An Efficient Solution to the Saddle Point Problem	Armen Aghajanyan
Energy-Based Spherical Sparse Coding	Bailey Kong, Charless C. Fowlkes
Revisiting Denoising Auto-Encoders	Luis Gonzalo Sanchez Giraldo
End-to-End Learnable Histogram Filters	Rico Jonschkowski, Oliver Brock
Rotation Plane Doubly Orthogonal Recurrent Neural Networks	Zoe McCarthy, Andrew Bai, Xi Chen, Pieter Abbeel
Near-Data Processing for Machine Learning	Hyeokjun Choe, Seil Lee, Hyunha Nam, Seongsik Park, Seijoon Kim, Eui-Young Chung, Sungroh Yoon
Investigating Recurrence and Eligibility Traces in Deep Q-Networks	Jean Harb, Doina Precup
Exploring the Application of Deep Learning for Supervised Learning Problems	Jose Rozanec, Gilad Katz, Eui Chul Richard Shin, Dawn Song
An Empirical Analysis of Deep Network Loss Surfaces	Daniel Jiwoong Im, Michael Tao, Kristin Branson
Unsupervised Learning Using Generative Adversarial Training And Clustering	Vittal Premachandran, Alan L. Yuille
#Exploration: A Study of Count-Based Exploration for Deep Reinforcement Learning	Haoran Tang, Rein Houthooft, Davis Foote, Adam Stooke, Xi Chen, Yan Duan, John Schulman, Filip De Turck, Pieter Abbeel
Prototypical Networks for Few-shot Learning	Jake Snell, Kevin Swersky, Richard Zemel
On orthogonality and learning recurrent networks with long term dependencies	Eugene Vorontsov, Chiheb Trabelsi, Samuel Kadoury, Chris Pal
Deep Neural Networks and the Tree of Life	Yan Wang, Kun He, John E. Hopcroft, Yu Sun
Generative Adversarial Parallelization	Daniel Jiwoong Im, He Ma, Chris Dongjoo Kim, Graham Taylor
b-GAN: Unified Framework of Generative Adversarial Networks	Masatosi Uehara, Issei Sato, Masahiro Suzuki, Kotaro Nakayama, Yutaka Matsuo
Higher Order Recurrent Neural Networks	Rohollah Soltani, Hui Jiang
Generative Adversarial Networks as Variational Training of Energy Based Models	Shuangfei Zhai, Yu Cheng, Rogerio Feris, Zhongfei Zhang
Introducing Active Learning for CNN under the light of Variational Inference	Melanie Ducoffe, Frederic Precioso
An Information Retrieval Approach for Finding Dependent Subspaces of Multiple Views	Ziyuan Lin, Jaakko Peltonen
Character-aware Attention Residual Network for Sentence Representation	Xin Zheng, Zhenzhou Wu
Attentive Recurrent Comparators	Pranav Shyam, Ambedkar Dukkipati
CAN AI GENERATE LOVE ADVICE?: TOWARD NEURAL ANSWER GENERATION FOR NON-FACTOID QUESTIONS	Makoto Nakatsuji, Hisashi Ito, Naruhiro Ikeda, Shota Sagara, Akihisa Fujita
Boosted Generative Models	Aditya Grover, Stefano Ermon
Adversarial examples for generative models	Jernej Kos, Ian Fischer, Dawn Song
Towards Information-Seeking Agents	Philip Bachman, Alessandro Sordoni, Adam Trischler
Multi-label learning with the RNNs for Fashion Search	Taewan Kim
Differentiable Canonical Correlation Analysis	Matthias Dorfer, Jan Schlüter, Gerhard Widmer
Generating Long and Diverse Responses with Neural Conversation Models	Louis Shao, Stephan Gouws, Denny Britz, Anna Goldie, Brian Strope, Ray Kurzweil
Understanding intermediate layers using linear classifier probes	Guillaume Alain, Yoshua Bengio
Improving Invariance and Equivariance Properties of Convolutional Neural Networks	Christopher Tensmeyer, Tony Martinez
TreNet: Hybrid Neural Networks for Learning the Local Trend in Time Series	Tao Lin, Tian Guo, Karl Aberer
Intelligible Language Modeling with Input Switched Affine Networks	Jakob Foerster, Justin Gilmer, Jan Chorowski, Jascha Sohl-dickstein, David Sussillo
Sequence generation with a physiologically plausible model of handwriting and Recurrent Mixture Density Networks	Daniel Berio, Memo Akten, Frederic Fol Leymarie, Mick Grierson, Réjean Plamondon
CONTENT2VEC: SPECIALIZING JOINT REPRESENTATIONS OF PRODUCT IMAGES AND TEXT FOR THE TASK OF PRODUCT RECOMMENDATION	Thomas Nedelec, Elena Smirnova, Flavian Vasile
Out-of-class novelty generation: an experimental foundation	Mehdi Cherti, Balázs Kégl, Akın Kazakçı
A Joint Many-Task Model: Growing a Neural Network for Multiple NLP Tasks	Kazuma Hashimoto, Caiming Xiong, Yoshimasa Tsuruoka, Richard Socher
Representation Stability as a Regularizer for Improved Text Analytics Transfer Learning	Matthew Riemer, Elham Khabiri, Richard Goodwin
Extensions and Limitations of the Neural GPU	Eric Price, Wojciech Zaremba, Ilya Sutskever
DeepRebirth: A General Approach for Accelerating Deep Neural Network Execution on Mobile Devices	Dawei Li, Xiaolong Wang, Deguang Kong, Mooi Choo Chuah
Semi-Supervised Detection of Extreme Weather Events in Large Climate Datasets	Evan Racah, Christopher Beckham, Tegan Maharaj, Prabhat, Christopher Pal
Structured Sequence Modeling with Graph Convolutional Recurrent Networks	Youngjoo Seo, Michaël Defferrard, Pierre Vandergheynst, Xavier Bresson
End-to-End Answer Chunk Extraction and Ranking for Reading Comprehension	Yang Yu, Wei Zhang, Bowen Zhou, Kazi Hasan, Mo Yu, Bing Xiang
Sample Importance in Training Deep Neural Networks	Tianxiang Gao, Vladimir Jojic
Epitomic Variational Autoencoders	Serena Yeung, Anitha Kannan, Yann Dauphin, Li Fei-Fei
Learning Disentangled Representations in Deep Generative Models	N. Siddharth, Brooks Paige, Alban Desmaison, Jan-Willem van de Meent, Frank Wood, Noah D. Goodman, Pushmeet Kohli, Philip H.S. Torr
Low-rank passthrough neural networks	Antonio Valerio Miceli Barone
Inference and Introspection in Deep Generative Models of Sparse Data	Rahul G. Krishnan, Matthew Hoffman
Implicit ReasoNet: Modeling Large-Scale Structured Relationships with Shared Memory	Yelong Shen*, Po-Sen Huang*, Ming-Wei Chang, Jianfeng Gao
Neural Combinatorial Optimization with Reinforcement Learning	Irwan Bello*, Hieu Pham*, Quoc V. Le, Mohammad Norouzi, Samy Bengio
Wav2Letter: an End-to-End ConvNet-based Speech Recognition System	Ronan Collobert, Christian Puhrsch, Gabriel Synnaeve
Recurrent Neural Networks for Multivariate Time Series with Missing Values	Zhengping Che, Sanjay Purushotham, Kyunghyun Cho, David Sontag, Yan Liu
Group Sparse CNNs for Question Sentence Classification with Answer Sets	Mingbo Ma, Liang Huang, Bing Xiang, Bowen Zhou
NEWSQA: A MACHINE COMPREHENSION DATASET	Adam Trischler, Tong Wang, Xingdi Yuan, Justin Harris, Alessandro Sordoni, Philip Bachman, Kaheer Suleman
Gated-Attention Readers for Text Comprehension	Bhuwan Dhingra, Hanxiao Liu, Zhilin Yang, William W. Cohen, Ruslan Salakhutdinov
Neural Code Completion	Chang Liu, Xin Wang, Richard Shin, Joseph E. Gonzalez, Dawn Song
Here's My Point: Argumentation Mining with Pointer Networks	Peter Potash, Alexey Romanov, Anna Rumshisky
Tree-Structured Variational Autoencoder	Richard Shin, Alexander A. Alemi, Geoffrey Irving, Oriol Vinyals
Learning Approximate Distribution-Sensitive Data Structures	Zenna Tavares, Armando Solar-Lezama
Memory-augmented Attention Modelling for Videos	Rasool Fakoor, Abdel-rahman Mohamed, Margaret Mitchell, Sing Bing Kang, Pushmeet Kohli
Taming the waves: sine as activation function in deep neural networks	Giambattista Parascandolo, Heikki Huttunen, Tuomas Virtanen
Convolutional Neural Networks Generalization Utilizing the Data Graph Structure	Yotam Hechtlinger, Purvasha Chakravarti, Jining Qin
Evaluation of Defensive Methods for DNNs against Multiple Adversarial Evasion Models	Xinyun Chen, Bo Li, Yevgeniy Vorobeychik
Collaborative Deep Embedding via Dual Networks	Yilei Xiong, Dahua Lin, Haoying Niu, JIefeng Cheng, Zhenguo Li
Transformation-based Models of Video Sequences	Joost van Amersfoort, Anitha Kannan, Marc'Aurelio Ranzato, Arthur Szlam, Du Tran, Soumith Chintala
Neural Causal Regularization under the Independence of Mechanisms Assumption	Mohammad Taha Bahadori, Krzysztof Chalupka, Edward Choi, Robert Chen, Walter F. Stewart, Jimeng Sun
Recurrent Coevolutionary Feature Embedding Processes for Recommendation	Hanjun Dai*, Yichen Wang*, Rakshit Trivedi, Le Song
L-SR1: A Second Order Optimization Method for Deep Learning	Vivek Ramamurthy, Nigel Duffy
Inverse Problems in Computer Vision using Adversarial Imagination Priors	Hsiao-Yu Fish Tung, Katerina Fragkiadaki
Leveraging Asynchronicity in Gradient Descent for Scalable Deep Learning	Jeff Daily, Abhinav Vishnu, Charles Siegel
Dynamic Steerable Frame Networks	Jörn-Henrik Jacobsen, Bert De Brabandere, Arnold W.M. Smeulders
Adding Gradient Noise Improves Learning for Very Deep Networks	Arvind Neelakantan, Luke Vilnis, Quoc V. Le, Lukasz Kaiser, Karol Kurach, Ilya Sutskever, James Martens
Joint Training of Ratings and Reviews with Recurrent Recommender Networks	Chao-Yuan Wu, Amr Ahmed, Alex Beutel, Alexander J. Smola
Counterpoint by Convolution	Cheng-Zhi Anna Huang, Tim Cooijmans, Adam Roberts, Aaron Courville, Douglas Eck
The loss surface of residual networks: Ensembles and the role of batch normalization	Etai Littwin, Lior Wolf
Eigenvalues of the Hessian in Deep Learning: Singularity and Beyond	Levent Sagun, Leon Bottou, Yann LeCun
Local minima in training of deep networks	Grzegorz Swirszcz, Wojciech Marian Czarnecki, Razvan Pascanu
Communicating Hierarchical Neural Controllers for Learning Zero-shot Task Generalization	Junhyuk Oh, Satinder Singh, Honglak Lee, Pushmeet Kohli
The Preimage of Rectifier Network Activities	Stefan Carlsson, Hossein Azizpour, Ali Razavian
Neural Machine Translation with Latent Semantic of Image and Text	Joji Toyama, Masanori Misono, Masahiro Suzuki, Kotaro Nakayama, Yutaka Matsuo
Submodular Sum-product Networks for Scene Understanding	Abram L. Friesen, Pedro Domingos
Human perception in computer vision	Ron Dekel
Efficient Summarization with Read-Again and Copy Mechanism	Wenyuan Zeng, Wenjie Luo, Sanja Fidler, Raquel Urtasun
Layer Recurrent Neural Networks	Weidi Xie, Alison Noble, Andrew Zisserman
Gaussian Attention Model and Its Application to Knowledge Base Embedding and Question Answering	Liwen Zhang, John Winn, Ryota Tomioka
Cooperative Training of Descriptor and Generator Networks	Jianwen Xie, Yang Lu, Ruiqi Gao, Song-Chun Zhu, Ying Nian Wu
Exploring LOTS in Deep Neural Networks	Andras Rozsa, Manuel Gunther, Terrance E. Boult
Warped Convolutions: Efficient Invariance to Spatial Transformations	Joao F. Henriques, Andrea Vedaldi
Adjusting for Dropout Variance in Batch Normalization and Weight Initialization	Dan Hendrycks, Kevin Gimpel
Rule Mining in Feature Space	Stefano Teso, Andrea Passerini
The Power of Sparsity in Convolutional Neural Networks	Soravit Changpinyo, Mark Sandler, Andrey Zhmoginov
Multi-view Generative Adversarial Networks	Mickaël Chen, Ludovic Denoyer
Beyond Bilingual: Multi-sense Word Embeddings using Multilingual Context	Shyam Upadhyay, Kai-Wei Chang, James Zou, Matt Taddy, Adam Kalai
Two Methods for Wild Variational Inference	Qiang Liu, Yihao Feng
Rethinking Numerical Representations for Deep Neural Networks	Parker Hill, Babak Zamirai, Shengshuo Lu, Yu-Wei Chao, Michael Laurenzano, Mehrzad Samadi, Marios Papaefthymiou, Scott Mahlke, Thomas Wenisch, Jia Deng, Lingjia Tang, Jason Mars
NEUROGENESIS-INSPIRED DICTIONARY LEARNING: ONLINE MODEL ADAPTION IN A CHANGING WORLD	Sahil Garg, Irina Rish, Guillermo Cecchi, Aurelie Lozano
Diverse Beam Search: Decoding Diverse Solutions from Neural Sequence Models	Ashwin K Vijayakumar, Michael Cogswell, Ramprasaath R. Selvaraju, Qing Sun, Stefan Lee, David Crandall, Dhruv Batra
Deep Generalized Canonical Correlation Analysis	Adrian Benton, Huda Khayrallah, Biman Gujral, Drew Reisinger, Sheng Zhang, Raman Arora
A Context-aware Attention Network for Interactive Question Answering	Huayu Li, Martin Renqiang Min, Yong Ge, Asim Kadav
Recurrent Inference Machines for Solving Inverse Problems	Patrick Putzky, Max Welling
Semi-Supervised Learning with Context-Conditional Generative Adversarial Networks	Emily Denton, Sam Gross, Rob Fergus
Investigating Different Context Types and Representations for Learning Word Embeddings	Bofang Li, Tao Liu, Zhe Zhao, Buzhou Tang, Xiaoyong Du
The Predictron: End-To-End Learning and Planning	David Silver, Hado van Hasselt, Matteo Hessel, Tom Schaul, Arthur Guez, Tim Harley, Gabriel Dulac-Arnold, David Reichert, Neil Rabinowitz, Andre Barreto, Thomas Degris
Bridging Nonlinearities and Stochastic Regularizers with Gaussian Error Linear Units	Dan Hendrycks, Kevin Gimpel
Alternating Direction Method of Multipliers for Sparse Convolutional Neural Networks	Farkhondeh Kiaee, Christian Gagné, and Mahdieh Abbasi
Inefficiency of stochastic gradient descent with larger mini-batches (and more learners)	Onkar Bhardwaj, Guojing Cong
The Variational Walkback Algorithm	Anirudh Goyal, Nan Rosemary Ke, Alex Lamb, Yoshua Bengio
Distributed Transfer Learning for Deep Convolutional Neural Networks by Basic Probability Assignment	Arash Shahriari
A hybrid network: Scattering and Convnet	Edouard Oyallon
FastText.zip: Compressing text classification models	Armand Joulin, Edouard Grave, Piotr Bojanowski, Matthijs Douze, Herve Jegou, Tomas Mikolov
Encoding and Decoding Representations with Sum- and Max-Product Networks	Antonio Vergari, Robert Peharz, Nicola Di Mauro, Floriana Esposito
Sequence to Sequence Transduction with Hard Monotonic Attention	Roee Aharoni, Yoav Goldberg
Improving Stochastic Gradient Descent with Feedback	Jayanth Koushik, Hiroaki Hayashi
Neural Graph Machines: Learning Neural Networks Using Graphs	Thang D. Bui, Sujith Ravi, Vivek Ramavajjala
Dynamic Neural Turing Machine with Continuous and Discrete Addressing Schemes	Caglar Gulcehre, Sarath Chandar, Kyunghyun Cho, Yoshua Bengio
Is a picture worth a thousand words? A Deep Multi-Modal Fusion Architecture for Product Classification in e-commerce	Tom Zahavy, Alessandro Magnani, Abhinandan Krishnan, Shie Mannor
Generative Adversarial Networks for Image Steganography	Denis Volkhonskiy, Boris Borisenko, Evgeny Burnaev
MS MARCO: A Human-Generated MAchine Reading COmprehension Dataset	Tri Nguyen, Mir Rosenberg, Xia Song, Jianfeng Gao, Saurabh Tiwary, Rangan Majumder, Li Deng
OMG: Orthogonal Method of Grouping With Application of K-Shot Learning	Haoqi Fan, Yu Zhang, Kris M. Kitani
GRAM: Graph-based Attention Model for Healthcare Representation Learning	Edward Choi, Mohammad Taha Bahadori, Le Song, Walter F. Stewart, Jimeng Sun
Regularizing Neural Networks by Penalizing Confident Output Distributions	Gabriel Pereyra, George Tucker, Jan Chorowski, Lukasz Kaiser, Geoffrey Hinton
Options Discovery with Budgeted Reinforcement Learning	Aurelia Léon, Ludovic Denoyer
Unsupervised Learning of State Representations for Multiple Tasks	Antonin Raffin, Sebastian Höfer, Rico Jonschkowski, Oliver Brock, Freek Stulp
DRAGNN: A Transition-Based Framework for Dynamically Connected Neural Networks	Lingpeng Kong, Chris Alberti, Daniel Andor, Ivan Bogatyy, David Weiss
Joint Multimodal Learning with Deep Generative Models	Masahiro Suzuki, Kotaro Nakayama, Yutaka Matsuo
Hierarchical Memory Networks	Sarath Chandar, Sungjin Ahn, Hugo Larochelle, Pascal Vincent, Gerald Tesauro, Yoshua Bengio
Towards Understanding the Invertibility of Convolutional Neural Networks	Anna C. Gilbert, Yi Zhang, Kibok Lee, Yuting Zhang, Honglak Lee
Incremental Sequence Learning	Edwin D. de Jong
Boosting Image Captioning with Attributes	Ting Yao, Yingwei Pan, Yehao Li, Zhaofan Qiu, Tao Mei
Skip-graph: Learning graph embeddings with an encoder-decoder model	John Boaz Lee, Xiangnan Kong
Finding a Jack-of-All-Trades: An Examination of Semi-supervised Learning in Reading Comprehension	Rudolf Kadlec, Ondřej Bajgar, Peter Hrincar, Jan Kleindienst
DyVEDeep: Dynamic Variable Effort Deep Neural Networks	Sanjay Ganapathy, Swagath Venkataramani, Balaraman Ravindran, Anand Raghunathan
Deep Character-Level Neural Machine Translation By Learning Morphology	Shenjian Zhao, Zhihua Zhang
Linear Time Complexity Deep Fourier Scattering Network and Extension to Nonlinear Invariants	Randall Balestriero, Herve Glotin
Annealing Gaussian into ReLU: a New Sampling Strategy for Leaky-ReLU RBM	Chun-Liang Li, Siamak Ravanbakhsh, Barnabas Poczos
Boosted Residual Networks	Alan Mosca, George D. Magoulas
Multi-task learning with deep model based reinforcement learning	Asier Mujika
Opening the vocabulary of neural language models with character-level word representations	Matthieu Labeau, Alexandre Allauzen
HFH: Homologically Functional Hashing for Compressing Deep Neural Networks	Lei Shi, Shikun Feng, Zhifan Zhu
The Incredible Shrinking Neural Network: New Perspectives on Learning Representations Through The Lens of Pruning	Nikolas Wolfe, Aditya Sharma, Lukas Drude, Bhiksha Raj
Efficient iterative policy optimization	Nicolas Le Roux
Tensorial Mixture Models	Or Sharir, Ronen Tamari, Nadav Cohen, Amnon Shashua
An Analysis of Deep Neural Network Models for Practical Applications	Alfredo Canziani, Adam Paszke, Eugenio Culurciello
Playing SNES in the Retro Learning Environment	Nadav Bhonker, Shai Rozenberg, Itay Hubara
Learning to Understand: Incorporating Local Contexts with Global Attention for Sentiment Classification	Zhigang Yuan, Yuting Hu, Yongfeng Huang
Fast Adaptation in Generative Models with Generative Matching Networks	Sergey Bartunov, Dmitry P. Vetrov
LipNet: End-to-End Sentence-level Lipreading	Yannis M. Assael, Brendan Shillingford, Shimon Whiteson, Nando de Freitas
A Simple yet Effective Method to Prune Dense Layers of Neural Networks	Mohammad Babaeizadeh, Paris Smaragdis, Roy H. Campbell
Emergent Predication Structure in Vector Representations of Neural Readers	Hai Wang, Takeshi Onishi, Kevin Gimpel, David McAllester
Riemannian Optimization for Skip-Gram Negative Sampling	Alexander Fonarev, Alexey Grinchuk, Gleb Gusev, Pavel Serdyukov, Ivan Oseledets
RL^2: Fast Reinforcement Learning via Slow Reinforcement Learning	Yan Duan, John Schulman, Xi Chen, Peter L. Bartlett, Ilya Sutskever, Pieter Abbeel
Deep Error-Correcting Output Codes	Guoqiang Zhong, Yuchen Zheng, Peng Zhang, Mengqi Li, Junyu Dong
Marginal Deep Architectures: Deep learning for Small and Middle Scale Applications	Yuchen Zheng, Guoqiang Zhong, Junyu Dong
Beyond Fine Tuning: A Modular Approach to Learning on Small Data	Aryk Anderson, Kyle Shaffer, Artem Yankov, Court Corley, Nathan Hodas
Classify or Select: Neural Architectures for Extractive Document Summarization	Ramesh Nallapati, Bowen Zhou and Mingbo Ma
Tartan: Accelerating Fully-Connected and Convolutional Layers in Deep Learning Networks by Exploiting Numerical Precision Variability	Alberto Delmás Lascorz, Sayeh Sharify, Patrick Judd, Andreas Moshovos
Machine Solver for Physics Word Problems	Megan Leszczynski, Jose Moreira
Learning Word-Like Units from Joint Audio-Visual Analylsis	David Harwath, James R. Glass
Multi-modal Variational Encoder-Decoders	Iulian V. Serban, Alexander G. Ororbia II, Joelle Pineau, Aaron Courville
Reference-Aware Language Models	Zichao Yang, Phil Blunsom, Chris Dyer, Wang Ling
Simple Black-Box Adversarial Perturbations for Deep Networks	Nina Narodytska, Shiva Kasiviswanathan
Unsupervised Pretraining for Sequence to Sequence Learning	Prajit Ramachandran, Peter J. Liu, Quoc V. Le
BIOACOUSTIC SEGMENTATION BY HIERARCHICAL DIRICHLET PROCESS HIDDEN MARKOV MODEL	Vincent Roger, Marius Bartcus, Faicel Chamroukhi, Hervé Glotin
Learning Recurrent Span Representations for Extractive Question Answering	Kenton Lee, Tom Kwiatkowksi, Ankur Parikh, Dipanjan Das
A Neural Stochastic Volatility Model	Rui Luo, Xiaojun Xu, Weinan Zhang, Jun Wang
Parametric Exponential Linear Unit for Deep Convolutional Neural Networks	Ludovic Trottier, Philippe Giguère, Brahim Chaib-draa
Unsupervised Deep Learning of State Representation Using Robotic Priors	Timothee LESORT, David FILLIAT
Coarse Pruning of Convolutional Neural Networks with Random Masks	Sajid Anwar, Wonyong Sung
ENet: A Deep Neural Network Architecture for Real-Time Semantic Segmentation	Adam Paszke, Abhishek Chaurasia, Sangpil Kim, Eugenio Culurciello
Understanding trained CNNs by indexing neuron selectivity	Ivet Rafegas, Maria Vanrell, Luís A. Alexandre
Multiagent System for Layer Free Network	Hiroki Kurotaki, Kotaro Nakayama, Yutaka Matsuo
Classless Association using Neural Networks	Federico Raue, Sebastian Palacio, Andreas Dengel, Marcus Liwicki
Cat2Vec: Learning Distributed Representation of Multi-field Categorical Data	Ying Wen, Jun Wang, Tianyao Chen, Weinan Zhang
Transformational Sparse Coding	Dimitrios C. Gklezakos, Rajesh P. N. Rao
Cortical-Inspired Open-Bigram Representation for Handwritten Word Recognition	Théodore Bluche, Christopher Kermorvant, Claude Touzet, Hervé Glotin
Representing inferential uncertainty in deep neural networks through sampling	Patrick McClure, Nikolaus Kriegeskorte
Making Stochastic Neural Networks from Deterministic Ones	Kimin Lee, Jaehyung Kim, Song Chong, Jinwoo Shin
Information Dropout: learning optimal representations through noise	Alessandro Achille, Stefano Soatto
ReasoNet: Learning to Stop Reading in Machine Comprehension	Yelong Shen, Po-Sen Huang, Jianfeng Gao, Weizhu Chen
Spatio-Temporal Abstractions in Reinforcement Learning Through Neural Encoding	Nir Baram, Tom Zahavy, Shie Mannor
Deep Symbolic Representation Learning for Heterogeneous Time-series Classification	Shengdong Zhang, Soheil Bahrampour, Naveen Ramakrishnan, Mohak Shah
A Way out of the Odyssey: Analyzing and Combining Recent Insights for LSTMs	Shayne Longpre, Sabeek Pradhan, Caiming Xiong, Richard Socher
Binary Paragraph Vectors	Karol Grzegorczyk, Marcin Kurdziel
Generative Paragraph Vector	Ruqing Zhang, Jiafeng Guo, Yanyan Lan, Jun Xu, Xueqi Cheng
LSTM-Based System-Call Language Modeling and Ensemble Method for Host-Based Intrusion Detection	Gyuwan Kim, Hayoon Yi, Jangho Lee, Yunheung Paek, Sungroh Yoon
Deep Variational Canonical Correlation Analysis	Weiran Wang, Xinchen Yan, Honglak Lee, Karen Livescu
Non-linear Dimensionality Regularizer for Solving Inverse Problems	Ravi Garg, Anders Eriksson, Ian Reid
Revisiting Batch Normalization For Practical Domain Adaptation	Yanghao Li, Naiyan Wang, Jianping Shi, Jiaying Liu, Xiaodi Hou
SqueezeNet: AlexNet-level accuracy with 50x fewer parameters and <0.5MB model size	Forrest N. Iandola, Song Han, Matthew W. Moskewicz, Khalid Ashraf, William J. Dally, Kurt Keutzer
Training Long Short-Term Memory With Sparsified Stochastic Gradient Descent	Maohua Zhu, Minsoo Rhu, Jason Clemons, Stephen W. Keckler, Yuan Xie
Efficient Calculation of Polynomial Features on Sparse Matrices	Andrew Nystrom, John Hughes
ParMAC: distributed optimisation of nested functions, with application to binary autoencoders	Miguel A. Carreira-Perpinan, Mehdi Alizadeh
Chess Game Concepts Emerge under Weak Supervision: A Case Study of Tic-tac-toe	Hao Zhao, Ming Lu, Anbang Yao, Yurong Chen, Li Zhang
On the Expressive Power of Deep Neural Networks	Maithra Raghu, Ben Poole, Jon Kleinberg, Surya Ganguli, Jascha Sohl-Dickstein
Universality in halting time	Levent Sagun, Thomas Trogdon, Yann LeCun
Learning Identity Mappings with Residual Gates	Pedro H. P. Savarese, Leonardo O. Mazza, Daniel R. Figueiredo
Parallel Stochastic Gradient Descent with Sound Combiners	Saeed Maleki, Madanlal Musuvathi, Todd Mytkowicz, Yufei Ding
Divide and Conquer with Neural Networks	Alex Nowak, Joan Bruna
Gradients of Counterfactuals	Mukund Sundararajan, Ankur Taly, Qiqi Yan
A Convolutional Encoder Model for Neural Machine Translation	Jonas Gehring, Michael Auli, David Grangier, Yann N. Dauphin
Deep Convolutional Neural Network Design Patterns	Leslie N. Smith, Nicholay Topin
An Analysis of Feature Regularization for Low-shot Learning	Zhuoyuan Chen, Han Zhao, Xiao Liu, Wei Xu
Combating Deep Reinforcement Learning's Sisyphean Curse with Intrinsic Fear	Zachary C. Lipton, Jianfeng Gao, Lihong Li, Jianshu Chen, Li Deng
Deep Unsupervised Clustering with Gaussian Mixture Variational Autoencoders	Nat Dilokthanakul, Pedro A. M. Mediano, Marta Garnelo, Matthew C.H. Lee, Hugh Salimbeni, Kai Arulkumaran, Murray Shanahan
Improved Architectures for Computer Go	Tristan Cazenave
Learning Python Code Suggestion with a Sparse Pointer Network	Avishkar Bhoopchand, Tim Rocktäschel, Earl Barr, Sebastian Riedel
Demystifying ResNet	Sihan Li, Jiantao Jiao, Yanjun Han, Tsachy Weissman
Learning similarity preserving representations with neural similarity and context encoders	Franziska Horn, Klaus-Robert Müller
Sentence Ordering using Recurrent Neural Networks	Lajanugen Logeswaran, Honglak Lee, Dragomir Radev
Knowledge Adaptation: Teaching to Adapt	Sebastian Ruder, Parsa Ghaffari, John G. Breslin
Enforcing constraints on outputs with unconstrained inference	Jay Yoon Lee, Michael L. Wick, Jean-Baptiste Tristan
Hierarchical compositional feature learning	Miguel Lazaro-Gredilla, Yi Liu, D. Scott Phoenix, Dileep George
Learning a Static Analyzer: A Case Study on a Toy Language	Manzil Zaheer, Jean-Baptiste Tristan, Michael L. Wick, Guy L. Steele Jr.
Filling in the details: Perceiving from low fidelity visual input	Farahnaz A. Wick, Michael L. Wick, Marc Pomplun
Modelling Relational Time Series using Gaussian Embeddings	Ludovic Dos Santos, Ali Ziat, Ludovic Denoyer, Benjamin Piwowarski, Patrick Gallinari
Compact Embedding of Binary-coded Inputs and Outputs using Bloom Filters	Joan Serrà, Alexandros Karatzoglou
A Deep Learning Approach for Joint Video Frame and Reward Prediction in Atari Games	Felix Leibfried, Nate Kushman, Katja Hofmann
Pedestrian Detection Based On Fast R-CNN and Batch Normalization	Zhong-Qiu Zhao, Haiman Bian, Donghui Hu, Herve Glotin
An Actor-critic Algorithm for Learning Rate Learning	Chang Xu, Tao Qin, Gang Wang, Tie-Yan Liu
Training Group Orthogonal Neural Networks with Privileged Information	Yunpeng Chen, Xiaojie Jin, Jiashi Feng, Shuicheng Yan
Progressive Attention Networks for Visual Attribute Prediction	Paul Hongsuck Seo, Zhe Lin, Scott Cohen, Xiaohui Shen, Bohyung Han
A Neural Knowledge Language Model	Sungjin Ahn, Heeyoul Choi, Tanel Parnamaa, Yoshua Bengio
Fuzzy paraphrases in learning word representations with a lexicon	Yuanzhi Ke, Masafumi Hagiwara
What Is the Best Practice for CNNs Applied to Visual Instance Retrieval?	Jiedong Hao, Jing Dong, Wei Wang, Tieniu Tan
Rectified Factor Networks for Biclustering	Djork-Arné Clevert, Thomas Unterthiner, Sepp Hochreiter
Sampling Generative Networks	Tom White
Learning Locomotion Skills Using DeepRL: Does the Choice of Action Space Matter?	Xue Bin Peng, Michiel van de Panne
Iterative Refinement for Machine Translation	Roman Novak, Michael Auli, David Grangier
Semantic Noise Modeling for Better Representation Learning	Hyo-Eun Kim, Sangheum Hwang, Kyunghyun Cho
Ternary Weight Decomposition and Binary Activation Encoding for Fast and Compact Neural Network	Mitsuru Ambai, Takuya Matsumoto, Takayoshi Yamashita, Hironobu Fujiyoshi
Vocabulary Selection Strategies for Neural Machine Translation	Gurvan L'Hostis, David Grangier, Michael Auli
Efficient Communications in Training Large Scale Neural Networks	Linnan Wang, Wei Wu, George Bosilca, Richard Vuduc, Zenglin Xu
Dynamic Partition Models	Marc Goessling, Yali Amit
Learning Efficient Algorithms with Hierarchical Attentive Memory	Marcin Andrychowicz, Karol Kurach
Revisiting Distributed Synchronous SGD	Jianmin Chen*, Xinghao Pan*, Rajat Monga, Samy Bengio, Rafal Jozefowicz
New Learning Approach By Genetic Algorithm In A Convolutional Neural Network For Pattern Recognition	Mohammad Ali Mehrolhassani, Majid Mohammadi
PREDICTION OF POTENTIAL HUMAN INTENTION USING SUPERVISED COMPETITIVE LEARNING	Masayoshi Ishikawa, Mariko Okude, Takehisa Nishida & Kazuo Muto
Conditional Image Synthesis With Auxiliary Classifier GANs	Augustus Odena, Christopher Olah, Jonathon Shlens
Multi-label learning with semantic embeddings	Liping Jing, MiaoMiao Cheng, Liu Yang, Alex Gittens, Michael W. Mahoney
Significance of Softmax-Based Features over Metric Learning-Based Features	Shota Horiguchi, Daiki Ikami, Kiyoharu Aizawa
Improving Sampling from Generative Autoencoders with Markov Chains	Antonia Creswell, Kai Arulkumaran, Anil Anthony Bharath
Learning to Protect Communications with Adversarial Neural Cryptography	Martín Abadi, David G. Andersen
Deep unsupervised learning through spatial contrasting	Elad Hoffer, Itay Hubara, Nir Ailon
SoftTarget Regularization: An Effective Technique to Reduce Over-Fitting in Neural Networks	Armen Aghajanyan
Surprisal-Driven Feedback in Recurrent Networks	Kamil Rocki
